11111111111111111111
10................01
1.11111111.1111111.1
1.........s........1
1.1111.111d111.111.1
1......1ggggg1.....1
1.1111.1111111.111.1
1..................1
1.11111111.1111111.1
1..................1
11111111111111111111